NO ./images/n_bonus.xpm
SO ./images/s_bonus.xpm
WE ./images/w_bonus.xpm
EA ./images/e_bonus.xpm

C 100,   150,  200
F 64 , 42 , 15

        1111111111111111111111111
        10C0000000110000000000001
        10110000011100000000000011111111111111111111111
        1001000000C00000000000001
111111111011000001110000000000001
10000000001100000111C11111O111111
11110111111111C11100000010001
1111C111111111011101010010001
11000000110101011100000010001
10000000000000001100000010001
100000000000000000010100C0001
110000011101010111110111100011
11110111 1110101 101111010N01
11111111 1111111 111111111111