NO images/n_bonus.xpm
SO images/s_bonus.xpm
WE images/w_bonus.xpm
EA images/e_bonus.xpm

C 100,   150,  200
F 64 , 42 , 250

 11111111111111 111111111
 
 11111111111111111
 110000000000000011111111    1111111111111111111
 110000000000000011111111    1111111100E00001111
 110000000000000011111111    1111111100000001111
 110000000000000011111111    1111111111111111111
 11111111111111111
 1111111
 1